%%%%%%%%%%%%%%%%
%G .P.o........%
%%%%%%%%%%%%%%.%
%..............%
%.%%%%%%%%%%%%%%
%..............%
%%%%%%%%%%%%%%%%